12
20
1 10 10 10 10 10 0 44 44 44 44 44 44 44 44 44 44 45 44 44 
3 45 45 45 45 45 2 44 44 44 44 44 44 44 44 44 44 44 44 44 
3 45 45 45 45 45 2 44 45 44 44 44 44 44 44 44 44 44 44 44 
3 45 45 45 45 45 2 44 44 44 45 44 44 44 44 44 44 44 44 45 
3 45 45 45 45 45 2 44 45 44 44 44 44 44 44 44 44 44 44 44 
5 13 13 13 13 13 4 44 44 44 44 44 44 44 44 44 44 45 45 44 
44 44 44 44 44 44 44 44 44 44 44 44 44 44 44 44 44 44 44 45 
44 45 44 44 44 44 44 45 44 1 10 10 10 10 45 10 10 10 10 0 
44 44 44 44 45 44 44 44 44 3 45 45 45 45 45 45 45 45 45 2 
1 11 0 44 44 44 44 44 44 3 45 45 32 12 12 13 33 45 45 2 
3 46 44 44 44 44 44 44 44 3 45 45 45 45 47 45 45 45 45 2 
5 13 4 44 44 44 44 45 44 5 12 12 12 12 12 12 12 12 12 4 
