12
20
9 21 21 21 21 21 8 44 44 44 44 44 44 44 44 44 44 44 44 46 
3 45 45 45 45 45 2 44 44 44 44 44 44 44 44 44 44 44 44 44 
3 45 45 45 45 45 2 44 44 44 44 44 44 44 44 44 44 44 44 44 
3 45 45 45 45 45 2 44 44 44 44 44 44 44 44 44 44 44 44 44 
3 45 45 45 45 45 2 44 44 44 44 44 44 44 44 44 44 44 44 44 
5 12 12 12 12 12 4 44 44 44 44 44 44 44 44 44 44 44 44 44 
44 44 44 44 44 44 44 44 44 44 44 44 44 44 44 44 44 44 44 44 
44 44 44 44 44 44 44 1 11 11 11 11 11 11 44 11 11 11 11 0 
1 11 11 11 0 44 44 3 46 45 45 45 45 45 45 45 45 45 45 2 
3 45 45 45 44 44 44 3 45 41 10 10 10 10 10 10 10 26 45 2 
3 46 45 45 44 44 44 3 45 45 45 45 45 47 45 45 45 45 45 2 
5 13 13 13 4 44 44 5 13 13 13 13 13 13 13 13 13 13 13 4 
