12
20
34 20 20 20 20 20 21 21 8 44 44 44 44 44 44 44 44 44 44 44 
24 47 46 47 45 45 45 45 2 44 44 44 44 44 44 44 44 44 44 44 
24 46 45 46 45 45 45 45 2 44 44 44 44 44 44 44 44 44 44 44 
24 47 46 47 45 45 45 45 2 44 44 44 44 44 44 44 44 44 44 44 
24 45 45 45 45 45 45 45 2 44 44 44 44 44 44 44 44 44 44 44 
24 45 45 45 45 45 45 45 2 44 44 44 44 44 44 44 44 44 44 44 
36 14 14 14 14 14 14 14 37 44 44 44 44 44 44 44 44 44 44 44 
20 20 20 20 20 20 20 20 20 44 44 44 44 44 44 44 44 44 44 44 
34 20 20 20 20 20 35 44 44 44 44 44 44 44 44 44 44 44 44 44 
24 47 45 45 46 45 25 44 44 44 44 44 44 34 10 10 44 10 10 43 
24 47 45 45 46 45 44 44 44 44 44 44 44 24 47 45 46 45 47 25 
36 14 14 14 14 14 37 44 44 44 44 44 44 36 14 14 14 14 14 37 
